+--------------------------------------------------------------------------------------------------+
|                                                                                                  |
|                                                                                                  |
|                                                                                                  |
|                                                                                                  |
|                                                                                                  |
|                                                                                                  |
|                                                    B                                             |
|                                                                                                  |
|                                                                                                  |
|                                                                                                  |
|                                            #############################################         |
|                                                                                                  |
|                                                                                                  |
|                                                                                                  |
|                                     ###########                                                  |
|                                    ##         ###                                                |
|                                   ##            ###                                              |
|                                  ##               #                                              |
|                                  #                                                               |
|     #     ##      #      #                                                                       |
|     ##     ########     ##                                                                       |
|      #                 ##                                                                        |
|      #                 #                                                                         |
|      ####           ####                                                                         |
|         #           #                                                                            |
|         #####      ##                                                                            |
|             ########                                                                             |
|                                                                                                  |
|                                        #                                    #                    |
|                                        #                                    #                    |
|                                        #                                    #                    |
|                                        #                                    #                    |
|                                        ######################################                    |
|                                        #                                    #                    |
|                                        #                                    #                    |
|                                        #                                    #                    |
|                                        #                                    #                    |
|                                                                                                  |
|                                                                                                  |
|                                                                                                  |
|                                                                                                  |
|                                                                                                  |
|                                                           A                                      |
|                                                                                                  |
|                                                                                                  |
+--------------------------------------------------------------------------------------------------+
